11111111111111111111111111111
100000000000000000F0000000001
10001111000C00000000011110001
10001001000000000000010010001
10001111000000000000011110001
100000000F0000C00000000000001
10P00000000000000000000000C01
10000011100000000001110000001
10000000111000000111000000001
10000F00001111111100000000001
1000000C0000111100000000F0001
100F00000000000000000000000E1
11111111111111111111111111111
