1111111111111111111111111
100000000000000000F000001
1000001100000011111100001
1000011000000000001100001
10001100000P0000011000001
1001111110000001100000001
1000001100000011000000C01
1000001100C00011111100001
100F0000000000000000000E1
1111111111111111111111111
