11111111111111111111
1P00000000F000C000E1
11111111111111111111
